17 18 17 17 17 17 17 17 17 18 17 17 17 17 18 18 17 18 17 17 18 17 17 18 18 18 17 17 18 17 17 17 17 17 18 17 18 18 18 17 17 17 18 18 18 17 18 17 17 18 17 18 17 18 18 17 18 17 17 17 17 17 17 17 17 17
18 17 17 17 18 17 17 17 18 18 18 17 17 17 17 18 18 18 17 17 18 18 17 18 18 17 18 17 17 18 18 18 17 18 17 18 17 17 17 18 18 17 18 17 17 18 18 17 18 17 18 17 18 17 18 17 17 18 17 17 17 17 17 17 17 17
17 17 17 17 17 17 18 17 18 17 17 17 18 17 18 18 17 18 18 18 18 18 17 17 17 18 17 18 18 17 18 17 17 17 17 17 18 18 18 17 17 17 18 18 17 18 18 17 17 18 17 18 17 18 18 17 17 17 17 17 17 17 17 17 17 17
17 17 17 18 17 17 18 17 18 17 18 18 18 18 18 17 17 17 18 18 17 17 17 18 18 17 18 18 17 17 17 18 18 18 17 17 17 17 18 18 18 17 17 18 18 17 18 18 17 17 18 18 18 17 18 17 18 18 17 17 17 17 17 17 17 17
18 17 17 17 17 18 18 17 18 17 17 17 18 17 17 18 18 17 17 18 18 18 17 17 17 17 17 18 18 17 18 17 18 17 18 18 18 17 18 17 17 18 18 17 17 17 18 18 18 17 18 17 17 18 17 18 17 17 17 17 17 17 17 17 17 17
18 17 17 17 17 17 17 18 17 17 18 18 17 17 18 18 17 18 17 18 17 18 18 18 17 17 18 18 18 17 17 18 17 18 18 18 17 18 18 17 18 17 18 17 18 18 17 18 17 17 18 18 17 17 18 17 18 18 17 17 17 17 17 17 17 17
17 18 17 17 18 17 17 17 1 0 2 1 0 0 0 0 0 3 0 0 0 1 0 1 0 0 0 0 4 0 0 1 0 5 0 4 0 0 1 0 0 4 2 0 0 5 0 0 0 5 0 0 0 0 4 2 0 0 17 17 17 18 17 17 17 17
17 17 17 18 17 17 17 17 5 4 0 4 4 4 4 4 0 0 0 3 0 0 0 0 0 0 0 0 0 2 0 0 0 1 0 0 0 5 0 0 2 0 0 0 0 0 0 3 0 4 0 2 0 0 5 0 0 0 17 17 17 17 18 17 17 18
17 18 17 17 17 17 18 17 1 4 0 4 0 0 0 4 0 2 0 4 0 0 5 0 0 5 0 4 0 0 0 0 0 0 1 0 0 0 2 0 1 0 0 0 4 0 5 0 1 0 0 0 2 0 1 0 4 1 17 17 18 17 17 17 17 18
17 17 17 17 18 17 17 17 0 4 0 4 0 4 0 4 0 0 0 0 0 0 0 0 1 0 0 0 0 0 0 2 0 0 0 0 0 0 0 0 0 0 0 1 0 0 0 0 0 0 5 0 0 0 0 0 1 0 17 17 17 17 18 17 18 17
17 17 18 17 17 18 17 18 0 4 0 4 4 4 0 4 0 0 0 4 0 0 0 0 0 0 0 0 1 0 0 0 0 0 3 0 0 0 0 0 4 0 0 0 0 0 0 0 0 0 0 1 0 0 3 0 5 5 17 18 17 18 17 17 17 17
17 18 17 17 17 17 17 17 0 4 0 0 0 0 0 4 0 0 0 0 0 0 0 5 0 0 0 0 0 0 4 0 0 0 0 0 0 0 3 0 0 0 0 1 0 0 0 2 0 0 0 0 0 0 5 5 5 5 17 17 18 17 18 17 18 18
17 17 17 18 17 18 17 17 1 4 4 4 4 4 4 4 0 0 1 0 0 0 0 0 0 0 4 0 0 0 0 0 0 0 1 0 0 0 0 0 0 0 0 0 0 5 0 0 0 0 0 0 0 5 5 5 5 0 17 17 17 18 17 17 18 17
17 18 17 17 17 18 17 17 0 0 0 5 0 0 0 0 0 0 0 0 0 0 0 0 0 0 0 0 0 0 0 0 3 0 0 0 0 0 0 0 0 2 0 0 0 0 0 0 0 0 1 0 5 5 5 5 5 0 17 18 17 17 17 17 17 17
17 17 17 17 18 17 17 17 0 2 0 0 0 0 0 1 0 0 0 0 0 0 2 0 0 0 0 0 3 0 0 1 0 0 0 0 0 1 0 0 0 0 0 0 3 0 0 0 3 0 0 0 5 5 5 5 0 0 18 17 17 18 18 17 18 17
17 17 18 17 17 17 17 17 5 0 0 0 0 1 0 0 0 0 3 0 0 0 0 0 0 0 0 0 0 4 0 0 0 0 0 0 0 0 0 0 0 0 2 0 0 0 0 0 0 0 0 5 5 5 5 5 0 0 18 17 18 17 17 17 17 18
17 17 18 17 17 17 17 17 0 0 0 0 0 0 0 0 0 0 0 0 0 1 0 0 0 0 0 0 0 0 0 0 0 0 0 0 0 0 0 1 0 0 0 0 0 0 1 0 0 2 0 5 5 5 5 0 0 0 17 17 17 17 17 17 18 17
17 18 17 17 18 17 18 17 0 0 2 0 0 0 0 0 0 3 0 0 0 0 0 0 0 5 0 0 0 0 0 0 0 0 0 4 0 0 0 0 0 0 0 0 0 0 0 0 0 0 5 5 5 5 0 0 0 0 17 18 17 17 17 18 17 17
17 17 17 17 17 18 17 17 0 0 0 0 0 0 0 4 0 0 0 0 0 0 0 2 0 0 0 0 0 1 0 0 0 0 0 0 0 0 0 1 0 0 0 0 0 4 0 0 0 0 5 5 5 5 0 0 0 0 17 17 18 17 17 17 18 17
17 18 17 17 17 17 18 18 1 0 0 0 0 0 0 0 0 0 0 1 0 0 0 0 0 0 0 0 0 0 0 0 0 0 0 0 2 0 0 0 0 0 0 0 0 0 0 0 0 5 5 5 5 0 0 0 0 0 17 18 17 17 18 17 17 17
17 17 17 18 17 17 17 17 0 0 0 0 2 0 0 0 0 0 0 0 0 4 0 0 0 0 5 0 0 0 0 0 0 1 0 0 0 0 0 0 0 0 0 3 0 0 0 0 0 5 5 5 0 0 0 0 0 0 17 18 17 17 17 17 18 17
17 18 17 18 17 18 18 17 0 1 0 0 0 0 0 0 0 0 0 0 0 0 0 0 0 0 0 0 0 0 0 0 0 0 0 0 1 0 0 0 2 0 0 0 0 0 0 0 0 0 0 0 0 0 0 0 0 0 17 17 17 18 17 17 17 18
17 17 17 17 17 18 17 18 0 0 0 0 0 0 5 0 0 0 1 0 0 0 2 0 0 0 1 0 0 0 0 0 0 0 0 0 0 0 0 0 0 0 0 0 0 0 0 0 0 0 0 0 0 0 0 0 0 0 18 17 18 17 17 18 17 17
17 17 18 17 17 17 17 17 0 2 0 0 0 0 0 0 0 0 0 0 0 0 0 0 0 0 0 0 0 0 0 0 0 0 0 4 0 0 0 0 0 0 0 0 0 0 0 0 0 0 0 0 0 0 0 0 0 0 17 17 18 17 17 17 18 17
17 17 17 17 18 17 17 18 0 0 0 4 0 0 0 0 0 1 0 0 0 0 0 0 0 0 0 0 4 0 0 0 0 0 0 0 0 0 1 0 0 0 0 0 0 0 0 0 0 5 5 5 0 0 0 0 0 0 17 18 17 17 17 18 17 17
17 17 17 17 17 17 17 17 0 5 0 0 0 0 0 0 0 0 0 0 0 0 0 0 0 0 2 0 0 0 0 0 4 0 0 0 0 0 0 0 0 0 0 0 0 2 0 0 0 5 5 5 5 0 0 0 0 0 17 17 17 17 18 17 18 17
17 18 17 18 17 17 18 17 0 0 0 0 0 0 2 0 0 0 0 3 0 0 0 0 0 0 0 0 0 0 0 0 0 0 0 0 1 0 0 0 0 0 0 0 0 0 0 0 0 0 5 5 5 5 0 0 0 0 17 17 18 17 18 17 17 17
17 17 17 17 17 17 17 17 0 1 0 0 0 0 0 0 0 0 0 0 0 0 0 1 0 0 0 0 0 0 0 2 0 0 0 0 0 0 0 0 1 0 0 0 0 0 0 0 0 0 5 5 5 5 0 0 0 0 18 18 17 17 17 18 17 17
17 17 17 17 18 17 17 17 4 0 0 0 0 0 0 0 1 0 0 0 0 0 0 0 0 0 0 1 0 0 0 0 0 5 0 0 0 0 0 0 0 0 0 0 0 0 0 0 0 0 0 5 5 5 5 0 0 0 17 17 18 17 17 17 18 17
17 17 17 17 18 17 17 17 0 0 0 0 0 4 0 0 0 0 2 0 0 0 0 0 0 0 0 0 0 0 0 0 0 0 0 0 0 2 0 0 0 0 0 0 0 1 0 0 0 0 0 5 5 5 5 5 0 0 18 17 17 17 18 17 17 18
17 18 17 17 17 17 17 17 0 1 0 0 0 0 0 0 0 0 0 0 0 0 2 0 0 0 0 0 0 0 0 1 0 0 0 0 0 0 0 0 1 0 0 0 0 0 0 0 0 2 0 0 5 5 5 5 0 0 17 18 17 17 17 18 17 17
17 17 17 17 18 17 18 17 0 0 0 0 4 0 0 0 0 0 0 1 0 0 0 0 0 0 2 0 0 0 0 0 0 0 0 0 0 0 0 0 0 0 0 0 0 0 0 0 0 0 0 0 5 5 5 5 5 0 18 17 17 17 18 17 18 17
17 17 18 17 17 17 17 17 0 0 0 0 0 0 0 2 0 0 0 0 0 0 0 0 0 0 0 0 3 0 0 0 0 0 0 0 0 1 0 0 0 0 0 0 0 0 1 0 0 0 0 0 0 5 5 5 5 0 17 17 17 18 17 17 17 17
17 18 17 17 17 18 18 17 0 0 0 0 0 0 0 0 0 0 0 0 0 0 4 0 0 0 0 0 0 0 0 0 0 0 0 0 0 0 0 0 0 0 0 0 0 0 0 0 0 0 0 0 0 0 5 5 5 5 18 17 18 17 17 18 17 18
18 17 17 17 17 17 17 17 0 2 0 0 0 0 0 0 1 0 0 0 0 0 0 0 0 0 0 0 0 0 0 5 0 0 0 0 0 0 0 0 0 2 0 0 0 0 0 0 0 0 0 1 0 0 0 0 5 5 17 17 17 17 18 17 17 17
17 18 17 18 17 17 18 17 0 0 0 0 0 0 0 0 0 0 0 0 0 0 0 0 0 0 2 0 0 0 0 0 0 0 0 0 0 0 21 10 10 10 10 10 11 0 0 0 0 0 0 0 0 0 0 0 0 0 17 17 18 17 18 17 17 18
17 17 17 17 17 18 17 18 5 0 0 0 0 0 0 0 0 2 0 0 0 0 0 0 0 0 0 0 0 0 0 0 0 0 0 1 0 0 23 15 15 15 15 15 12 0 0 0 0 0 0 0 0 0 0 0 0 0 17 17 18 17 17 17 18 17
17 18 17 17 17 17 17 17 0 0 0 0 4 0 0 0 0 0 0 0 0 0 0 0 1 0 0 0 0 0 4 0 0 0 0 0 0 0 23 15 19 14 14 14 13 0 0 0 0 3 0 0 0 0 0 1 0 0 17 17 17 17 17 17 18 17
18 17 17 18 18 17 17 17 0 0 0 0 0 0 0 0 0 4 0 0 0 0 0 0 0 0 0 0 0 0 0 0 0 0 1 0 0 0 31 32 33 0 0 0 16 0 0 2 0 0 0 0 0 0 0 0 0 0 17 17 18 17 18 17 18 18
17 18 17 17 17 17 18 18 0 1 0 0 0 5 0 0 0 0 0 0 0 0 3 0 0 0 0 0 2 0 0 0 0 0 0 0 0 2 28 29 30 0 0 4 0 0 0 0 0 0 0 0 1 0 0 0 5 0 17 17 17 17 17 17 17 18
17 17 17 18 17 17 17 17 0 0 0 0 0 0 0 0 0 0 5 0 0 0 0 0 0 2 0 0 0 0 0 0 0 0 0 0 0 0 25 26 27 2 0 0 0 0 0 0 0 0 0 5 0 0 0 0 0 0 17 17 17 18 17 17 17 17
17 17 18 17 17 17 18 17 0 0 0 2 0 0 0 0 1 0 0 0 0 4 0 0 0 0 0 0 0 2 0 0 0 0 0 0 0 1 34 0 16 0 0 0 1 0 0 0 0 0 0 0 0 0 0 1 0 0 17 17 17 17 17 18 17 17
17 18 17 17 17 18 17 17 0 1 0 0 0 0 0 0 0 0 0 0 0 0 0 0 0 0 0 0 0 0 0 0 0 1 0 0 0 0 0 0 0 0 0 0 0 0 0 0 4 0 0 0 0 0 0 0 0 2 18 17 17 18 17 17 18 17
17 17 17 18 17 18 17 18 1 0 0 0 0 0 5 0 0 0 0 0 0 4 0 0 0 0 0 0 0 1 0 0 0 0 0 0 0 0 5 0 0 0 0 0 0 2 0 0 0 0 3 0 0 0 0 0 0 0 17 18 17 17 17 18 17 17
17 17 17 17 18 17 17 17 17 18 17 17 17 17 18 18 17 18 17 17 18 17 17 18 18 18 17 17 18 17 17 17 17 17 18 17 18 18 18 17 17 17 18 18 18 17 18 17 17 18 17 18 17 18 18 17 18 17 17 17 17 17 17 17 18 17
17 17 18 17 17 17 17 17 18 18 18 17 17 17 17 18 18 18 17 17 18 18 17 18 18 17 18 17 17 18 18 18 17 18 17 18 17 17 17 18 18 17 18 17 17 18 18 17 18 17 18 17 18 17 18 17 17 18 17 18 17 17 18 18 17 18
17 17 17 18 17 17 17 18 17 17 17 17 18 17 18 18 17 18 18 18 18 18 17 17 17 18 17 18 18 17 18 17 17 17 17 17 18 18 18 17 17 17 18 18 17 18 18 17 17 18 17 18 17 18 18 17 17 17 18 17 17 17 17 17 17 18
17 17 17 18 17 17 18 17 18 17 18 18 18 18 18 17 17 17 18 18 17 17 17 18 18 17 18 18 17 17 17 18 18 18 17 17 17 17 18 18 18 17 17 18 18 17 18 18 17 17 18 18 18 17 18 17 18 18 17 18 17 18 17 18 17 17
17 18 17 17 17 17 17 17 18 17 17 17 18 17 17 18 18 17 17 18 18 18 17 17 17 17 17 18 18 17 18 17 18 17 18 18 18 17 18 17 17 18 18 17 17 17 18 18 18 17 18 17 17 18 17 18 17 17 17 17 17 17 17 18 17 18
17 18 17 17 17 18 17 17 17 17 18 18 17 17 18 18 17 18 17 18 17 18 18 18 17 17 18 18 18 17 17 18 17 18 18 18 17 18 18 17 18 17 18 17 18 18 17 18 17 17 18 18 17 17 18 17 18 18 18 17 17 18 17 17 17 18